WWWWWWWWWWWWWWWWWWWWWWWWWWWWW
WFFFFFFFFFFFHFFFFFFFFFFFFFFFW
WFFFFFFFFFFFFFFFFFFFFFFFFFFFW
WFFFWWWWFFFFFFFFFFFFFFWWWWFFW
WFFFWWWWFFFFFFFFFFFFFFWWWWFFW
WFFFFFFFFFFFFFFFFFFFFFFFFFFFW
WFFFFFFFFFFFFFFFFFFFFFFFFFFFW
WFFFFFFFFFFFFFFFFFFFFFFFFFFFW
WFFFFFFFFFFFFFFFFFFFFFFFFFFFW
WFFFFFFFFFFFFFFFFFFFFFFFFFFFW
WFFFFFFFFFFFFFFFFFFFFFFFFFFFW
WFFFFFFFFFFFFFFFFFFFFFFFFFFFW
WFFFWWWWFFFFFFFFFFFFFFWWWWFFW
WFFFWWWWFFFFFFFFFFFFFFWWWWFFW
WFFFFFFFFFFFFFFFFFFFFFFFFFFFW
WFFFFFFFFFFFFFFFFFFFFFFFFFFFW
WWWWWWWWWWWWWWWWWWWWWWWWWWWWW